Before,After,log before,log after,dif in logs,dif
105,85,4.65,4.44,0.21,20
50,74,3.91,4.3,-0.39,-24
136,145,4.91,4.98,-0.07,-9
90,86,4.5,4.45,0.05,4
122,148,4.8,5,-0.2,-26
132,148,4.88,5,-0.12,-16
131,150,4.88,5.01,-0.13,-19
119,142,4.78,4.96,-0.18,-23
145,151,4.98,5.02,-0.04,-6
130,113,4.87,4.73,0.14,17
116,118,4.75,4.77,-0.02,-2
110,99,4.7,4.6,0.1,11
138,150,4.93,5.01,-0.08,-12
